LISTA DE ADYACENCIAS: 
Westport -> Dublin, 
Gdansk -> Warsaw, 
Krakow -> Warsaw, 
Warsaw -> Poznan, Wroclaw, Vienna, Krakow, Gdansk, Bialystok, 
Venice -> Vienna, Ljubljana, Milan, Florence, 
Split -> Zagreb, 
Riga -> Vilnius, Tallinn, 
Wroclaw -> Prague, Warsaw, 
Rennes -> Paris, 
Paris -> Bordeaux, Lyon, Frankfurt, Rennes, Brussels, London, 
Trondheim -> Östersund, 
Östersund -> Stockholm, Trondheim, 
Bergen -> Oslo, 
Oslo -> Stockholm, Bergen, Copenhagen, 
Nice -> Milan, Marseille, 
Catania -> Napoles, 
Napoles -> Rome, Catania, 
Marseille -> Lyon, Montpellier, Nice, 
Pamplona -> Madrid, 
Santander -> Madrid, 
Santiago de Compostela -> Madrid, 
Málaga -> Madrid, 
Bristol -> London, 
Penzance -> London, 
Porto -> Lisboa, 
Faro -> Lisboa, Sevilla, 
Lisboa -> Faro, Porto, 
Klaipeda -> Vilnius, 
Kiruna -> Stockholm, 
Holyhead -> Birmingham, Dublin, 
Rovaniemi -> Helsinki, 
Turku -> Helsinki, 
Tallinn -> Helsinki, Riga, Stockholm, 
Helsinki -> Tallinn, Turku, Rovaniemi, 
Hamburg -> Copenhagen, Berlin, Munich, Frankfurt, 
Glasgow -> Edinburgh, 
Aberdeen -> Edinburgh, 
Birmingham -> Edinburgh, Holyhead, London, 
Edinburgh -> Birmingham, Aberdeen, Glasgow, 
Cork -> Dublin, 
Stockholm -> Copenhagen, Kiruna, Oslo, Östersund, Tallinn, 
Copenhagen -> Stockholm, Hamburg, Oslo, 
Ljubljana -> Budapest, Zagreb, Venice, 
Vienna -> Budapest, Munich, Prague, Venice, Warsaw, 
Krakau -> Budapest, 
Budapest -> Krakau, Vienna, Bucharest, Ljubljana, Zagreb, Belgrade, 
London -> Brussels, Penzance, Bristol, Birmingham, Paris, 
Brussels -> Frankfurt, London, Cologne, Amsterdam, Paris, 
Bordeaux -> Lyon, Madrid, Paris, 
Florence -> Bologna, Rome, Venice, 
Bologna -> Milan, Florence, 
Vilnius -> Bialystok, Klaipeda, Riga, 
Bialystok -> Vilnius, Warsaw, 
Lyon -> Bern, Bordeaux, Marseille, Paris, 
Frankfurt -> Bern, Brussels, Cologne, Hamburg, Munich, Paris, 
Rome -> Bern, Napoles, Florence, 
Milan -> Bern, Bologna, Munich, Nice, Venice, 
Bern -> Milan, Rome, Frankfurt, Lyon, 
Poznan -> Berlin, Warsaw, 
Prague -> Berlin, Munich, Vienna, Wroclaw, 
Munich -> Berlin, Hamburg, Vienna, Frankfurt, Milan, Prague, 
Cologne -> Berlin, Brussels, Amsterdam, Frankfurt, 
Amsterdam -> Berlin, Brussels, Cologne, 
Berlin -> Amsterdam, Cologne, Munich, Prague, Poznan, Hamburg, 
Skopje -> Belgrade, Thessaloniki, Sofia, 
Sofia -> Belgrade, Bucharest, Skopje, Thessaloniki, Istanbul, 
Bucharest -> Belgrade, Budapest, Sofia, 
Bari -> Patras, 
Zagreb -> Belgrade, Budapest, Ljubljana, Split, 
Belgrade -> Zagreb, Bucharest, Sofia, Skopje, Budapest, 
Dublin -> Belfast, Cork, Holyhead, Westport, 
Belfast -> Dublin, 
Valencia -> Barcelona, Madrid, 
Sevilla -> Barcelona, Madrid, Faro, 
Madrid -> Barcelona, Valencia, Málaga, Sevilla, Santiago de Compostela, Santander, Pamplona, Bordeaux, 
Montpellier -> Barcelona, Marseille, 
Barcelona -> Montpellier, Madrid, Sevilla, Valencia, 
Patras -> Athens, Bari, 
Thessaloniki -> Athens, Skopje, Sofia, 
Athens -> Thessaloniki, Patras, 
Istanbul -> Ankara, Sofia, 
Ankara -> Istanbul, 
